1111111111111
1C01000000001
10C0010111001
1P0011E00000v
1111111111111