111111111111111111111111111111
1C1000100010P010001000100010E1
101010101010101010101010101011
101010101010101010101010101011
101010101010101010101010101011
101010101010101010101010101011
101010101010101010101010101011
101010101010101010101010101011
101010101010101010101010101011
101010101010101010101010101011
101010101010101010101010101011
101010101010101010101010101011
101010101010101010101010101011
101010101010101010101010101011
100010001000100010001000100011
111111111111111111111111111111