1111111111111111111111111
10P0000001000100010000001
1011101011000100010111011
10001C0010000100010000001
1010101010111110111111101
1000000000CCC0000000000E1
1111111111111111111111111
