1111111111111111111111111
10P0000001000100010000001
10111010110C0100010111011
10001C001000010001C000001
1010101010111110111111101
1000000000C0000C0000000E1
1111111111111111111111111