1111111111111
1C010000000C1
10C0010111001
1000111111111
1E000000000011
1010010100101
1010010010101
1P0000000C001
1111111111111
1111111111111